Product Category,Upgrade Count,Repair Count,Migrate Count,Install Count,Remove Count,CQR Count
Optical Transport Equipment,20,4,2,1,2,29
Other Transport Device,7,7,5,0,0,19
FIBER OPTIC TRANSPORT - FDP / OSP,3,1,0,7,0,11
Microwave TX/RX (Licensed),2,5,0,0,0,7
DC Backup System,2,1,0,1,0,4
Antenna System,0,1,0,2,0,3
"Cables, jumpers, and connectors",1,1,0,1,0,3
Generator,1,1,0,0,0,2
CSU / DSU,0,0,1,0,0,1
Tower Structure,0,1,0,0,0,1
